C 255,50,60
on peut ecrire nawak


oojoijoijoij

NO ./textures/try1.XPM

SO ./textures/try5.XPM


kikouu
WE ./textures/try3.XPM

F 60,50,70


EA ./textures/try6.XPM





     1111111111111111111111111111  111
        1000000000110000000000001  1 1
        1011000001110000000000001  111
        1001000000000000000000001
111111111011000001110000000000001
100000000011000001110111111111111
11110111111111011100000010001           1 1 1
11110111111111011101010010001          1
11000000110101011100000011111        111
1000000000000000110000001   1      110011
1N00000000000000110101001   1       1111
1100000111010101111101111   111       11 1 1 1
11110111 1110101 10111101   1
11111111 1111111 111111111111
